"filename", "language", "Python", "Markdown", "HTML", "comment", "blank", "total"
"/Users/wilsonvinson/Documents/GitHub/SUGT06/.github/ISSUE_TEMPLATE/bug_report.md", "Markdown", 0, 30, 0, 0, 9, 39
"/Users/wilsonvinson/Documents/GitHub/SUGT06/.github/ISSUE_TEMPLATE/feature_request.md", "Markdown", 0, 15, 0, 0, 6, 21
"/Users/wilsonvinson/Documents/GitHub/SUGT06/CODE_OF_CONDUCT.md", "Markdown", 0, 93, 0, 0, 36, 129
"/Users/wilsonvinson/Documents/GitHub/SUGT06/CONTRIBUTING.md", "Markdown", 0, 1, 0, 0, 1, 2
"/Users/wilsonvinson/Documents/GitHub/SUGT06/README.md", "Markdown", 0, 164, 0, 0, 39, 203
"/Users/wilsonvinson/Documents/GitHub/SUGT06/Tinyland MacOS/moyu_engine/config/components/animation_machine.py", "Python", 4, 0, 0, 20, 5, 29
"/Users/wilsonvinson/Documents/GitHub/SUGT06/Tinyland MacOS/moyu_engine/config/components/button.py", "Python", 20, 0, 0, 1, 9, 30
"/Users/wilsonvinson/Documents/GitHub/SUGT06/Tinyland MacOS/moyu_engine/config/components/graphics_loarder.py", "Python", 11, 0, 0, 0, 3, 14
"/Users/wilsonvinson/Documents/GitHub/SUGT06/Tinyland MacOS/moyu_engine/config/components/scrollbar.py", "Python", 23, 0, 0, 2, 18, 43
"/Users/wilsonvinson/Documents/GitHub/SUGT06/Tinyland MacOS/moyu_engine/config/components/tilemap_button.py", "Python", 33, 0, 0, 0, 19, 52
"/Users/wilsonvinson/Documents/GitHub/SUGT06/Tinyland MacOS/moyu_engine/config/components/tilemap_manager.py", "Python", 102, 0, 0, 20, 69, 191
"/Users/wilsonvinson/Documents/GitHub/SUGT06/Tinyland MacOS/moyu_engine/config/components/window_move.py", "Python", 11, 0, 0, 0, 2, 13
"/Users/wilsonvinson/Documents/GitHub/SUGT06/Tinyland MacOS/moyu_engine/config/components/window_zoom.py", "Python", 17, 0, 0, 0, 2, 19
"/Users/wilsonvinson/Documents/GitHub/SUGT06/Tinyland MacOS/moyu_engine/config/constants.py", "Python", 57, 0, 0, 11, 34, 102
"/Users/wilsonvinson/Documents/GitHub/SUGT06/Tinyland MacOS/moyu_engine/config/event/game_main_event.py", "Python", 96, 0, 0, 0, 45, 141
"/Users/wilsonvinson/Documents/GitHub/SUGT06/Tinyland MacOS/moyu_engine/config/event/menu_main_event.py", "Python", 18, 0, 0, 0, 8, 26
"/Users/wilsonvinson/Documents/GitHub/SUGT06/Tinyland MacOS/moyu_engine/config/event/menu_setting_event.py", "Python", 0, 0, 0, 0, 1, 1
"/Users/wilsonvinson/Documents/GitHub/SUGT06/Tinyland MacOS/moyu_engine/config/event/menu_stop_event.py", "Python", 0, 0, 0, 0, 1, 1
"/Users/wilsonvinson/Documents/GitHub/SUGT06/Tinyland MacOS/moyu_engine/config/font.py", "Python", 4, 0, 0, 0, 4, 8
"/Users/wilsonvinson/Documents/GitHub/SUGT06/Tinyland MacOS/moyu_engine/config/graphics.py", "Python", 35, 0, 0, 5, 26, 66
"/Users/wilsonvinson/Documents/GitHub/SUGT06/Tinyland MacOS/moyu_engine/config/setup.py", "Python", 36, 0, 0, 0, 22, 58
"/Users/wilsonvinson/Documents/GitHub/SUGT06/Tinyland MacOS/moyu_engine/config/sound.py", "Python", 3, 0, 0, 0, 3, 6
"/Users/wilsonvinson/Documents/GitHub/SUGT06/Tinyland MacOS/moyu_engine/config/surface/game_main_surface.py", "Python", 57, 0, 0, 10, 26, 93
"/Users/wilsonvinson/Documents/GitHub/SUGT06/Tinyland MacOS/moyu_engine/config/surface/menu_main_surface.py", "Python", 16, 0, 0, 0, 11, 27
"/Users/wilsonvinson/Documents/GitHub/SUGT06/Tinyland MacOS/moyu_engine/config/surface/menu_setting_surface.py", "Python", 0, 0, 0, 0, 1, 1
"/Users/wilsonvinson/Documents/GitHub/SUGT06/Tinyland MacOS/moyu_engine/config/surface/menu_stop_surface.py", "Python", 0, 0, 0, 0, 1, 1
"/Users/wilsonvinson/Documents/GitHub/SUGT06/Tinyland WinOS/moyu_engine/config/components/animation_machine.py", "Python", 4, 0, 0, 20, 5, 29
"/Users/wilsonvinson/Documents/GitHub/SUGT06/Tinyland WinOS/moyu_engine/config/components/button.py", "Python", 20, 0, 0, 1, 9, 30
"/Users/wilsonvinson/Documents/GitHub/SUGT06/Tinyland WinOS/moyu_engine/config/components/graphics_loarder.py", "Python", 11, 0, 0, 0, 3, 14
"/Users/wilsonvinson/Documents/GitHub/SUGT06/Tinyland WinOS/moyu_engine/config/components/scrollbar.py", "Python", 23, 0, 0, 2, 18, 43
"/Users/wilsonvinson/Documents/GitHub/SUGT06/Tinyland WinOS/moyu_engine/config/components/tilemap_button.py", "Python", 33, 0, 0, 0, 19, 52
"/Users/wilsonvinson/Documents/GitHub/SUGT06/Tinyland WinOS/moyu_engine/config/components/tilemap_manager.py", "Python", 102, 0, 0, 20, 69, 191
"/Users/wilsonvinson/Documents/GitHub/SUGT06/Tinyland WinOS/moyu_engine/config/components/window_move.py", "Python", 11, 0, 0, 0, 2, 13
"/Users/wilsonvinson/Documents/GitHub/SUGT06/Tinyland WinOS/moyu_engine/config/components/window_zoom.py", "Python", 17, 0, 0, 0, 2, 19
"/Users/wilsonvinson/Documents/GitHub/SUGT06/Tinyland WinOS/moyu_engine/config/constants.py", "Python", 57, 0, 0, 11, 34, 102
"/Users/wilsonvinson/Documents/GitHub/SUGT06/Tinyland WinOS/moyu_engine/config/event/game_main_event.py", "Python", 96, 0, 0, 0, 45, 141
"/Users/wilsonvinson/Documents/GitHub/SUGT06/Tinyland WinOS/moyu_engine/config/event/menu_main_event.py", "Python", 18, 0, 0, 0, 8, 26
"/Users/wilsonvinson/Documents/GitHub/SUGT06/Tinyland WinOS/moyu_engine/config/event/menu_setting_event.py", "Python", 0, 0, 0, 0, 1, 1
"/Users/wilsonvinson/Documents/GitHub/SUGT06/Tinyland WinOS/moyu_engine/config/event/menu_stop_event.py", "Python", 0, 0, 0, 0, 1, 1
"/Users/wilsonvinson/Documents/GitHub/SUGT06/Tinyland WinOS/moyu_engine/config/font.py", "Python", 4, 0, 0, 0, 4, 8
"/Users/wilsonvinson/Documents/GitHub/SUGT06/Tinyland WinOS/moyu_engine/config/graphics.py", "Python", 35, 0, 0, 5, 26, 66
"/Users/wilsonvinson/Documents/GitHub/SUGT06/Tinyland WinOS/moyu_engine/config/setup.py", "Python", 36, 0, 0, 0, 22, 58
"/Users/wilsonvinson/Documents/GitHub/SUGT06/Tinyland WinOS/moyu_engine/config/sound.py", "Python", 3, 0, 0, 0, 3, 6
"/Users/wilsonvinson/Documents/GitHub/SUGT06/Tinyland WinOS/moyu_engine/config/surface/game_main_surface.py", "Python", 57, 0, 0, 10, 26, 93
"/Users/wilsonvinson/Documents/GitHub/SUGT06/Tinyland WinOS/moyu_engine/config/surface/menu_main_surface.py", "Python", 16, 0, 0, 0, 11, 27
"/Users/wilsonvinson/Documents/GitHub/SUGT06/Tinyland WinOS/moyu_engine/config/surface/menu_setting_surface.py", "Python", 0, 0, 0, 0, 1, 1
"/Users/wilsonvinson/Documents/GitHub/SUGT06/Tinyland WinOS/moyu_engine/config/surface/menu_stop_surface.py", "Python", 0, 0, 0, 0, 1, 1
"/Users/wilsonvinson/Documents/GitHub/SUGT06/build/Tinyland/xref-Tinyland.html", "HTML", 0, 0, 15899, 0, 2951, 18850
"/Users/wilsonvinson/Documents/GitHub/SUGT06/init.py", "Python", 13, 0, 0, 0, 7, 20
"/Users/wilsonvinson/Documents/GitHub/SUGT06/moyu_engine/config/components/animation_machine.py", "Python", 4, 0, 0, 20, 5, 29
"/Users/wilsonvinson/Documents/GitHub/SUGT06/moyu_engine/config/components/black_field.py", "Python", 9, 0, 0, 0, 4, 13
"/Users/wilsonvinson/Documents/GitHub/SUGT06/moyu_engine/config/components/button.py", "Python", 20, 0, 0, 1, 9, 30
"/Users/wilsonvinson/Documents/GitHub/SUGT06/moyu_engine/config/components/graphics_loarder.py", "Python", 11, 0, 0, 0, 3, 14
"/Users/wilsonvinson/Documents/GitHub/SUGT06/moyu_engine/config/components/read_data.py", "Python", 7, 0, 0, 24, 9, 40
"/Users/wilsonvinson/Documents/GitHub/SUGT06/moyu_engine/config/components/save_data.py", "Python", 7, 0, 0, 27, 8, 42
"/Users/wilsonvinson/Documents/GitHub/SUGT06/moyu_engine/config/components/scrollbar.py", "Python", 23, 0, 0, 2, 18, 43
"/Users/wilsonvinson/Documents/GitHub/SUGT06/moyu_engine/config/components/text_inputbox.py", "Python", 51, 0, 0, 0, 8, 59
"/Users/wilsonvinson/Documents/GitHub/SUGT06/moyu_engine/config/components/tilemap_button.py", "Python", 33, 0, 0, 0, 19, 52
"/Users/wilsonvinson/Documents/GitHub/SUGT06/moyu_engine/config/components/tilemap_manager.py", "Python", 108, 0, 0, 22, 73, 203
"/Users/wilsonvinson/Documents/GitHub/SUGT06/moyu_engine/config/components/window_move.py", "Python", 11, 0, 0, 0, 2, 13
"/Users/wilsonvinson/Documents/GitHub/SUGT06/moyu_engine/config/components/window_zoom.py", "Python", 17, 0, 0, 0, 2, 19
"/Users/wilsonvinson/Documents/GitHub/SUGT06/moyu_engine/config/constants.py", "Python", 71, 0, 0, 13, 43, 127
"/Users/wilsonvinson/Documents/GitHub/SUGT06/moyu_engine/config/event/#menu_about_event.py", "Python", 0, 0, 0, 0, 1, 1
"/Users/wilsonvinson/Documents/GitHub/SUGT06/moyu_engine/config/event/#menu_createmap_event.py", "Python", 0, 0, 0, 0, 1, 1
"/Users/wilsonvinson/Documents/GitHub/SUGT06/moyu_engine/config/event/#menu_setting_event.py", "Python", 0, 0, 0, 0, 1, 1
"/Users/wilsonvinson/Documents/GitHub/SUGT06/moyu_engine/config/event/#menu_stop_event.py", "Python", 0, 0, 0, 0, 1, 1
"/Users/wilsonvinson/Documents/GitHub/SUGT06/moyu_engine/config/event/GAMEmain_event.py", "Python", 102, 0, 0, 0, 47, 149
"/Users/wilsonvinson/Documents/GitHub/SUGT06/moyu_engine/config/event/MENUmain_event.py", "Python", 34, 0, 0, 0, 18, 52
"/Users/wilsonvinson/Documents/GitHub/SUGT06/moyu_engine/config/font.py", "Python", 4, 0, 0, 0, 4, 8
"/Users/wilsonvinson/Documents/GitHub/SUGT06/moyu_engine/config/graphics.py", "Python", 47, 0, 0, 5, 30, 82
"/Users/wilsonvinson/Documents/GitHub/SUGT06/moyu_engine/config/setup.py", "Python", 35, 0, 0, 2, 22, 59
"/Users/wilsonvinson/Documents/GitHub/SUGT06/moyu_engine/config/sound.py", "Python", 3, 0, 0, 0, 3, 6
"/Users/wilsonvinson/Documents/GitHub/SUGT06/moyu_engine/config/surface/#menu_about_surface.py", "Python", 0, 0, 0, 0, 1, 1
"/Users/wilsonvinson/Documents/GitHub/SUGT06/moyu_engine/config/surface/#menu_createmap_surface.py", "Python", 0, 0, 0, 0, 1, 1
"/Users/wilsonvinson/Documents/GitHub/SUGT06/moyu_engine/config/surface/#menu_setting_surface.py", "Python", 0, 0, 0, 0, 1, 1
"/Users/wilsonvinson/Documents/GitHub/SUGT06/moyu_engine/config/surface/#menu_stop_surface.py", "Python", 0, 0, 0, 0, 1, 1
"/Users/wilsonvinson/Documents/GitHub/SUGT06/moyu_engine/config/surface/GAMEmain_surface.py", "Python", 56, 0, 0, 10, 25, 91
"/Users/wilsonvinson/Documents/GitHub/SUGT06/moyu_engine/config/surface/MENUmain_surface.py", "Python", 46, 0, 0, 1, 24, 71
"Total", "-", 1798, 303, 15899, 265, 4053, 22318